{
  "tiles" : [ [0, 0, 0, 0, 1, 0, 0, 0, 0 ],
              [0, 0, 1, 1, 1, 1, 1, 0, 0 ],
              [0, 1, 1, 1, 1, 1, 1, 1, 0 ],
              [0, 1, 1, 1, 1, 1, 1, 1, 0 ],
              [1, 1, 1, 1, 1, 1, 1, 1, 1 ],
              [0, 1, 1, 1, 1, 1, 1, 1, 0 ],
              [0, 1, 1, 1, 1, 1, 1, 1, 0 ],
              [0, 0, 1, 1, 1, 1, 1, 0, 0 ],
              [0, 0, 0, 0, 1, 0, 0, 0, 0 ] ],

  "targetScore" : 4050,
  "moves" : 90,
  
  "isTimed" : 1,
  "time" : 1220,
  
  "collectableTarget" : 11,
}
