{
  "tiles" : [ [1, 1, 0, 0, 1, 0, 0, 1, 1 ],
              [1, 0, 0, 1, 1, 1, 0, 0, 1 ],
              [0, 0, 1, 1, 1, 1, 1, 0, 0 ],
              [0, 1, 1, 1, 1, 1, 1, 1, 0 ],
              [1, 1, 1, 1, 1, 1, 1, 1, 1 ],
              [0, 1, 1, 1, 1, 1, 1, 1, 0 ],
              [0, 0, 1, 1, 1, 1, 1, 0, 0 ],
              [1, 0, 0, 1, 1, 1, 0, 0, 1 ],
              [1, 1, 0, 0, 1, 0, 0, 1, 1 ] ],

  "targetScore" : 450,
  "moves" : 18,
  
  "isTimed" : 1,
  "time" : 135,
  
  "collectableTarget" : 1,
}
