{
  "tiles" : [ [0, 1, 0, 1, 0, 1, 0, 1, 0 ],
              [1, 1, 1, 1, 1, 1, 1, 1, 1 ],
              [0, 1, 0, 1, 0, 1, 0, 1, 0 ],
              [1, 1, 1, 1, 1, 1, 1, 1, 1 ],
              [0, 1, 0, 1, 0, 1, 0, 1, 0 ],
              [1, 1, 1, 1, 1, 1, 1, 1, 1 ],
              [0, 1, 0, 1, 0, 1, 0, 1, 0 ],
              [1, 1, 1, 1, 1, 1, 1, 1, 1 ],
              [0, 1, 0, 1, 0, 1, 0, 1, 0 ] ],

  "targetScore" : 2250,
  "moves" : 54,
  
  "isTimed" : 1,
  "time" : 675,
  
  "collectableTarget" : 7,
}
